3 13 31
###############################
#p   ** **    *b  2          f#
# # # #*# # # # # # # # # # # #
#*     ** * *  *   * ** 5 *   #
# # # # # #*# # # # # # #*# # #
#*   *s*    *** * x **        #
# # # # # # # # # # # # # #*# #
#    *     * d      *    **  3#
# #*# # #*#*#*#*# # #1# # #*# #
#        *   *2*    *   *     #
#*# # # # # # # # # # #*# # #*#
# *    * **    ** ***     1   #
###############################