2 13 31
###############################
#p * *2       *f ** * *      *#
# # # # #*# # #*# # # # # #*# #
#    * * *** **      *    **  #
#s#*# # # # #1# #b#1# # # # #*#
#          *     **      *  **#
# # #*# # # # # #*#*#*#*# # # #
#   *        *   * *x* *      #
# # # #2#*# #d# # # # #*# #*# #
#   ****         *1           #
# # # #b# # # # # #*# # # # #*#
#  ** *   *    2              #
###############################