4 13 31
###############################
#p    * **  5 *s  3   4       #
# # # #*# # # # # # # # # # # #
#      ** * *  *   * ** 3 *   #
# # # # # #*# # # # # # #*# # #
#*   * *    *b*f*   **        #
# # # # # # # # # # # # # #*# #
#    *     *        *    **  3#
# #*# #d#*#*#*#*# # #1# # #*# #
#        * 5 *2*    *   *     #
#*# # # # # # # # # # #*# # #*#
#x*    * **    ** ***     1   #
###############################