5 13 31
###############################
#p * *3       *f ** * *      *#
# # # # #*# # #*#d# # # # #*# #
#    * * *** **  5   *    **  #
# #*# # # # #4# #b#1# # # # #*#
#          *     **      *  **#
#s# #*# # # # # #*#*#*#*# # # #
#   *        *   * *x* *   4  #
# # # # #*# # # # # # #*# #*# #
#   ****         *2           #
# # # # # # # # # #*# # # # #*#
#  ** *5  *    2     d        #
###############################